$$$..............
..$..............
.............@...
@.$...##&...%%%..
$$$..............
.................
...###...........
.........###.....
.................
..............$$$
.*...............
#################