#####################
#...................#
#-------#$#$$$$#$#..#
#.......#........#..#
#.......#........#..#
###...###.....@..#..#
#.......%..&..&..#..#
#.......%........#..#
#-------#$#$$$$#$#..#
#.......#........#..#
#.......#........#..#
###...###.....@..#..#
#.......%..&..&..#..#
#.......%........#..#
#-------#$#$$$$#$#..#
#.......#........#..#
#.......#........#..#
###...###.....@..#..#
#.......%..&..&..#..#
#.......%........#..#
#-------#$$$$$$$$#..#
#.......#........#..#
#...*...#........#.@#
#########........####