......##
......%@
....&###
*.....$@
########