##################
#.......#........#
#.......#.......@#
#......@#....#####
#....####........#
#.......#........#
#.......#..%.....#
#....####........#
#.......%........#
#.......%.....%..#
#....####........#
#.......#........#
#.......####.....#
#..#......*#.....#
#.......#--####..#
#.......#.....%..#
###############&&#