................................##########
................................#........#
................................#........#
...........................######.......@#
...........................#....%......###
...........................#....%........#
...........................#....###......#
...........................#..###........#
...........................#..###........#
...........................#..###......###
...........................#..###........#
...........................#..###......###
...........................#..###........#
...........................#..###......###
...........................#..#..........#
...........................#%%#-###......#
...........................#.@.%#........#
...........................##&###........#
...........%%%%%%%%%%%%%........#...##...#
...........%...........%........#........#
...........%...........%........#........#
...........%.....@.....%........#......###
#..........%.....&.....%........#........#
#..........%...........%........#........#
#..........%..#.....#..%........#####--###
#.*........%...........%........%@%....###
############$$$$$$$$$$$##########&########
...........#...........#..................
...........#...........#..................
...........#...........#..................