*............
###&$$#%%####
#.....#.....#
#..#######..#
#.....#.....#
####..#..####
#.....#.....#
#..#######..#
#....#@..#..#
###..##$$#..#
#@%.........#
#############